0	0	0	0	0	0	0	0	0	0	0	0	0	0	0	0	0	0	0	0	0	0	0	0	0	0	0	0	0	0	0	0
0	0	0	0	0	0	0	0	0	0	0	0	0	0	0	0	0	0	0	0	0	0	0	0	0	0	0	0	0	0	0	0
0	0	0	0	0	0	0	0	0	0	0	0	0	0	0	0	0	0	0	0	0	0	0	0	0	0	0	0	0	0	0	0
0	0	0	0	0	0	0	0	0	0	0	0	0	0	0	0	0	0	0	0	0	0	0	0	0	0	0	0	0	0	0	0
0	0	0	0	0	0	0	0	0	0	0	0	0	0	0	0	0	0	0	0	0	0	0	0	0	0	0	0	0	0	0	0
0	0	0	0	0	0	0	0	0	0	0	0	0	0	0	0	0	0	0	0	0	0	0	0	0	0	0	0	0	0	0	0
0	0	0	0	0	0	0	0	0	0	0	0	14	14	14	14	14	14	14	0	0	0	0	0	0	0	0	0	0	0	0	0
0	0	0	0	0	0	0	0	0	0	0	0	0	14	14	14	14	14	0	0	0	0	0	0	0	0	0	0	0	0	0	0
0	0	0	0	0	0	0	0	14	14	0	0	0	14	14	14	14	14	0	0	0	14	14	14	14	14	0	0	0	0	0	0
14	14	14	14	14	14	0	0	14	14	0	0	0	0	14	14	14	0	0	0	0	0	0	14	14	14	14	14	0	0	0	0
14	14	14	14	14	0	0	0	14	14	0	0	0	0	14	14	14	0	0	0	0	0	0	0	14	14	14	14	0	0	0	0
14	14	14	14	0	0	0	14	14	14	0	0	0	0	14	14	14	0	0	0	0	0	0	0	14	14	14	14	14	0	0	0
14	14	14	0	0	0	0	14	14	14	0	0	0	0	0	14	14	0	0	0	0	0	0	0	0	14	14	14	14	14	14	0
14	14	14	0	0	0	0	14	14	14	0	0	0	0	0	14	14	0	0	0	0	0	0	0	0	0	14	14	14	14	14	0
14	14	0	0	0	0	0	14	14	14	0	0	0	0	0	14	14	0	0	0	0	0	0	0	0	0	14	14	14	14	14	14
14	14	0	0	0	0	14	14	14	14	14	0	0	0	0	14	0	0	0	0	0	0	0	0	0	0	0	0	14	14	14	14
14	0	0	0	0	0	14	14	14	14	14	0	0	0	0	14	0	0	0	0	0	0	0	0	0	0	0	0	14	14	14	14
14	2	2	2	2	14	14	14	14	14	14	14	2	2	2	14	2	2	2	2	2	2	2	2	2	2	2	2	2	14	14	14
