0	0	0	0	0	0	0	0	0	0	0	0	0	0	0	0	0	0	0	0	0	0	0	0	0	0	0	0	0	0	0	0
0	0	0	0	0	0	0	0	0	0	0	0	0	0	0	0	0	0	0	0	0	0	0	0	0	0	0	0	0	0	0	0
0	0	0	0	0	0	0	0	0	0	0	0	0	0	0	0	0	0	0	0	0	0	0	0	0	0	0	0	0	0	0	0
14	14	14	14	14	0	0	0	14	14	14	14	14	0	0	0	14	14	14	14	14	0	0	0	14	14	14	14	14	0	0	0
14	14	14	14	14	0	0	0	14	14	14	14	14	0	0	0	14	14	14	14	14	0	0	0	14	14	14	14	14	0	0	0
14	14	14	14	14	0	0	0	14	14	14	14	14	0	0	0	14	14	14	14	14	0	0	0	14	14	14	14	14	0	0	0
14	14	14	14	14	0	0	0	14	14	14	14	14	0	0	0	14	14	14	14	14	0	0	0	14	14	14	14	14	0	0	0
14	14	14	14	14	0	0	0	14	14	14	14	14	0	0	0	14	14	14	14	14	0	0	0	14	14	14	14	14	0	0	0
0	0	0	0	0	0	0	0	0	0	0	0	0	0	0	0	0	0	0	0	0	0	0	0	0	0	0	0	0	0	0	0
0	0	0	0	0	0	0	0	0	0	0	0	0	0	0	0	0	0	0	0	0	0	0	0	0	0	0	0	0	0	0	0
0	7	7	7	0	0	0	0	0	7	7	7	0	0	0	0	0	7	7	7	0	0	0	0	0	7	7	7	0	0	0	0
0	0	0	0	0	0	0	0	0	0	0	0	0	0	0	0	0	0	0	0	0	0	0	0	0	0	0	0	0	0	0	0
0	0	0	0	0	0	0	0	0	0	0	0	0	0	0	0	0	0	0	0	0	0	0	0	0	0	0	0	0	0	0	0
14	14	14	14	14	0	0	0	14	14	14	14	14	0	0	0	14	14	14	14	14	0	0	0	14	14	14	14	14	0	0	0
14	14	14	14	14	0	0	0	14	14	14	14	14	0	0	0	14	14	14	14	14	0	0	0	14	14	14	14	14	0	0	0
14	14	14	14	14	0	0	0	14	14	14	14	14	0	0	0	14	14	14	14	14	0	0	0	14	14	14	14	14	0	0	0
14	14	14	14	14	0	0	0	14	14	14	14	14	0	0	0	14	14	14	14	14	0	0	0	14	14	14	14	14	0	0	0
14	14	14	14	14	0	0	0	14	14	14	14	14	0	0	0	14	14	14	14	14	0	0	0	14	14	14	14	14	0	0	0
