0	0	0	0	0	0	0	0	0	0	0	0	0	0	0	0	0	0	0	0	0	0	0	0	0	0	0	0	0	0	0	0
0	0	0	0	0	0	0	0	0	0	0	0	0	0	0	0	0	0	0	0	0	0	0	0	0	0	0	0	0	0	0	0
0	0	0	0	0	0	0	0	0	0	0	0	0	0	0	0	0	0	0	0	0	0	0	0	0	0	0	0	0	0	0	0
0	0	0	0	0	0	0	0	0	0	0	0	0	0	0	0	0	0	0	0	0	0	0	0	0	0	0	0	0	0	0	0
0	0	0	0	0	0	0	0	0	0	0	0	11	11	11	11	11	11	11	11	11	0	0	0	0	0	0	0	0	0	0	0
0	0	0	0	0	0	0	0	0	0	0	0	0	0	0	0	0	0	0	0	0	0	0	0	0	0	0	0	0	0	0	0
0	0	0	0	0	0	0	0	0	0	0	0	0	0	0	0	0	0	0	0	0	0	0	0	0	0	0	0	0	0	0	0
0	0	0	0	0	0	0	0	0	0	0	0	0	0	0	0	0	0	0	0	0	0	0	0	0	0	0	0	0	0	0	0
0	0	0	0	0	0	0	0	0	0	0	0	0	0	0	0	0	0	0	0	0	0	0	0	0	0	0	0	0	0	0	0
0	0	0	0	0	0	0	0	0	0	0	0	0	0	0	0	0	0	0	0	0	0	0	0	0	0	0	0	0	0	0	0
0	0	0	0	0	0	0	0	0	0	0	0	0	0	14	14	14	14	14	0	0	0	0	0	0	0	0	0	0	0	0	0
0	0	0	0	0	0	0	0	0	0	0	0	0	0	14	14	14	14	14	0	0	0	0	0	0	0	0	0	0	0	0	0
0	0	0	2	0	0	0	2	0	0	0	0	0	0	14	14	14	14	14	0	0	0	0	0	0	3	0	0	0	0	0	0
14	14	14	0	14	14	14	0	14	14	14	0	0	0	14	14	14	14	14	0	0	0	14	14	14	14	0	0	0	3	0	0
14	14	14	0	14	14	14	0	14	14	14	0	0	0	14	14	14	14	14	0	0	0	14	14	14	0	0	14	14	14	0	0
14	14	14	0	14	14	14	0	14	14	14	0	0	0	14	14	14	14	14	0	0	0	14	14	14	0	0	14	14	0	0	0
14	14	14	0	14	14	14	0	14	14	14	0	0	0	14	14	14	14	14	0	0	0	14	14	14	0	0	14	14	0	0	0
14	14	14	0	14	14	14	0	14	14	14	0	0	0	14	14	14	14	14	0	0	0	14	14	14	0	0	14	14	0	0	0
