0	0	0	0	0	0	0	0	0	0	0	0	0	0	0	14	0	0	0	0	0	0	0	0	0	0	0	0	0	0	0	0
0	0	0	0	0	0	0	0	0	0	0	0	0	0	14	14	14	0	0	0	0	0	0	0	0	0	0	0	0	0	0	0
0	0	0	14	0	0	0	0	2	0	0	0	0	14	14	14	14	14	0	0	0	0	2	0	0	0	0	14	0	0	0	0
0	0	14	14	14	0	0	2	2	2	0	0	0	14	14	14	14	14	0	0	0	2	2	2	0	0	14	14	14	0	0	0
0	0	14	14	14	0	0	0	2	0	0	0	14	14	14	14	14	14	14	0	0	0	2	0	0	0	14	14	14	0	0	0
0	14	14	14	14	14	0	0	0	0	0	0	14	14	14	14	14	14	14	0	0	0	0	0	0	14	14	14	14	14	0	0
0	14	14	14	14	14	0	0	0	0	0	14	14	14	14	14	14	14	14	14	0	0	0	0	0	14	14	14	14	14	0	0
14	14	14	14	14	14	14	0	0	0	0	14	14	14	14	14	14	14	14	14	0	0	0	0	14	14	14	14	14	14	14	0
14	14	14	14	14	14	14	0	0	0	14	14	14	14	14	14	14	14	14	14	14	0	0	0	14	14	14	14	14	14	14	0
14	14	14	14	14	14	14	0	0	0	14	14	14	14	14	14	14	14	14	14	14	0	0	0	14	14	14	14	14	14	14	0
0	14	14	14	14	14	0	0	0	0	0	14	14	14	14	14	14	14	14	14	0	0	0	0	0	14	14	14	14	14	0	0
0	14	14	14	14	14	0	0	0	0	0	14	14	14	14	14	14	14	14	14	0	0	0	0	0	14	14	14	14	14	0	0
0	0	14	14	14	0	0	0	0	0	0	0	14	14	14	14	14	14	14	0	0	0	0	0	0	0	14	14	14	0	0	0
0	0	14	14	14	0	0	0	2	0	0	0	14	14	14	14	14	14	14	0	0	0	2	0	0	0	14	14	14	0	0	0
0	0	0	14	0	0	0	2	2	2	0	0	0	14	14	14	14	14	0	0	0	2	2	2	0	0	0	14	0	0	0	0
0	0	0	0	0	0	0	0	2	0	0	0	0	14	14	14	14	14	0	0	0	0	2	0	0	0	0	0	0	0	0	0
0	0	0	0	0	0	0	0	0	0	0	0	0	0	14	14	14	0	0	0	0	0	0	0	0	0	0	0	0	0	0	0
0	0	0	0	0	0	0	0	0	0	0	0	0	0	0	14	0	0	0	0	0	0	0	0	0	0	0	0	0	0	0	0
